111111111111111111111111111
100010000000000100000000021
100010000010000100000000001
100010000000000100000000001
100011101011111100000000001
100000001000000100000000001
100000001000000100000000001
100000001000000100000000001
101111111111110100000000001
100000000000000100000000001
100000000000000100000000001
100000000000000100000000001
100010000000000100000000001
100010000000000100000000001
100010000000000100000000001
100010000000000100000000001
100011111000000100000000001
100000000000000100000000001
100000000000000100000000001
100000000000000000000000001
111111111111111111111111111
ENDL
11111
10001
11001
10001
10001
10001
10001
10001
12001
11111
ENDL
11111111111111111111
10000000000000000001
10111111111111111001
10100000000000001001
10101111111111101001
10101000000000101001
10101011111110101001
10101010000000101001
10101010111110101001
10101010100000101001
10101010101110101001
10101010101010101001
10101010101011101001
10101010101010001001
10101010101010101001
10101010101010111001
10101010101010101001
10000000000000000021
11111111111111111111
ENDL
11111111111111111111111111111111111111111111111111
10000000000000000000000000000000000000000000000001
10111111111111111111111111111111111111111111111001
10010000000000000010000000000000000000000000001001
10110111111111111110111111111111111111111111111001
10010110000000000010010010000000000010000000001001
10110110111111111110110110111111111110111111111001
10000010000000000000000010000000000000000000001001
11110111111111111111111111111111111111111111111001
10010101000000000010010010000000000010010000001001
10110101011111111110111111111111111110110111111001
10010000010000000010000010000000000010010000001001
11111110111111111111111111111111111111111111111001
10000000010000000010000010000000000010000000001001
10111111111111111110111110111111111111111111111001
10010010000000000010010010000000000010010000001001
10110110111111111110110110111111111112111111111001
10000000000000000000000000000000000000000000001001
11111111111111111111111111111111111111111111111111
ENDL