111111111111111111111111111
100010000000000100000000021
100010000010000100000000001
100010000000000100000000001
100011101011111100000000001
100000001000000100000000001
100000001000000100000000001
100000001000000100000000001
101111111111110100000000001
100000000000000100000000001
100000000000000100000000001
100000000000000100000000001
100010000000000100000000001
100010000000000100000000001
100010000000000100000000001
100010000000000100000000001
100011111000000100000000001
100000000000000100000000001
100000000000000100000000001
100000000000000000000000001
111111111111111111111111111
ENDL
11111
10001
11001
10001
10001
10001
10001
10001
12001
11111
ENDL
11111111111111111111
10000000000000000001
10111111111111111001
10100000000000001001
10101111111111101001
10101000000000101001
10101011111110101001
10101010000000101001
10101010111110101001
10101010100000101001
10101010101110101001
10101010101010101001
10101010101011101001
10101010101010001001
10101010101010101001
10101010101010111001
10101010101010101001
10000000000000000021
11111111111111111111
ENDL
11111111111111111111111111111111111111111111111111
10000000000000000000000000000000000000000000000001
10111111111111111111111111111111111111111111111001
10010000000000000010000000000000000000000000001001
10110111111111111110111111111111111111111111111001
10010110000000000010010010000000000010000000001001
10110110111111111110110110111111111110111111111001
10000010000000000000000010000000000000000000001001
11110111111111111111111111111111111111111111111001
10010101000000000010010010000000000010010000001001
10110101011111111110111111111111111110110111111001
10010000010000000010000010000000000010010000001001
11111110111111111111111111111111111111111111111001
10000000010000000010000010000000000010000000001001
10111111111111111110111110111111111111111111111001
10010010000000000010010010000000000010010000001001
10110110111111111110110110111111111112111111111001
10000000000000000000000000000000000000000000001001
11111111111111111111111111111111111111111111111111
ENDL
11111111111111111111
10001010000111101101
11101001010011000001
10001100011000010101
10110101000110101011
10000010110010000001
11101010000100110101
10011001010111001001
11000101011000010011
10101001100010100111
10100010001110001011
10101100110001101001
10001101000101001101
10110001010010010001
10101010011001010101
10100011000100011001
10110100110110100011
10010101100001001001
11000100001100011121
11111111111111111111
ENDL
11111111111111111111
10100000010000000011
10101010110101101001
10101001000110100101
10101010011000101001
10100110110010100101
10010100001010010101
11010001100011010101
10010111011011100101
11001000001001001001
10100011100101010011
10110100001001001101
10001101010100100001
11010001010101001011
10010110100010010001
10100100001010100111
10010111101001010001
10110001101010001101
10000100001000100021
11111111111111111111
ENDL
11111111111111111111
10001000000100010001
11101011010101001011
10101001010100100001
10101110001110010101
10100001100101010011
10011100010000001011
11000011011111101001
10010111000000010101
10110010110111000001
10001000001000111101
11010101010010000001
10010010001001011111
10110110110010100001
10000100100100011011
11110101001101000011
10010101010001111001
10100101010110001011
10001000000100100021
11111111111111111111
ENDL
11111111111111111111
10001000010001000001
11100101010100111011
11010001010010100011
10001101001010001001
10100010010011011101
10111100100100101101
10000001001110000001
10101010010100110101
10100100100101001001
10011001001001100101
11000010101010010011
10111100001001001001
10000001101010100101
10101011110010110001
10011001110100000101
11000100100101101001
10010010010110001101
10111001000000110021
11111111111111111111
ENDL
11111111111111111111
10000010010111000101
11111001000010010001
10001101101000101101
10100100010010100001
10010011010111001101
10101001010010010001
10100010010110100101
10010100111000101001
11010010010011000101
10010101011001110011
10100001000100001001
10101010110010101111
10010010001011100001
11001000101000010101
10101011100111001001
10000100011000101011
10111001011010000011
10000010000001011021
11111111111111111111
ENDL
11111111111111111111
10110000100000100001
10001010001101001101
10100111010000010001
10010010001011111011
10111010101100010001
10010010100001010101
10100101101101010011
11001100000010001001
10010101111100100101
11010010000001011001
10011001011110000111
11000100010000110001
10110101000111000101
10000110111000101001
11010100000010110011
10011001010110010111
10100010101000100011
10001100000010001021
11111111111111111111
ENDL
11111111111111111111
10100101001000000011
10001000010010101001
11101010100100010111
10001011001001100001
10110000011010101101
10100101100010001001
10010101001100101011
11010100110001010001
10001010000100010111
10101001111011010001
11001100000001100101
10010001111100011001
10100100000011000011
10010010111000110111
11001110001101010011
10010001010001001001
10100101110101100101
10001000000100010021
11111111111111111111
ENDL
11111111111111111111
10101000010100000001
10100011010001101101
10010100010100010101
11010011010011010101
10001010011100010001
10110011000001100111
10001010111110101101
11100010100000100001
10011100001110011101
11000111010000100101
10010000010111001001
10110111001000011011
10001000101010110011
10100010101010000101
10101100010011111001
10010001010100001011
11010110110101010001
10010000000001000121
11111111111111111111
ENDL
11111111111111111111
10010000010000100011
11000110100110001001
10111010010011100101
10000001001000010111
10110101010010110001
10001011001110001101
10100000100001010101
10010110010100100001
11001011001010101101
10101001100010101011
10100100101100100001
10110010100001101101
10001000101110001001
10100110010001110011
10101001001100000111
10101100101001010011
10100110000111001001
10010000110000011121
11111111111111111111
ENDL
11111111111111111111
10100100100000000001
10010010101101110101
10101000100010001001
10100101111010101011
10010001101001001011
10100100000100011001
10010011010011000101
11011100001010101001
11000010100100001011
10111010110001110001
10001010001010000101
10101010101100101001
10110011000101001011
10000100010100110011
10111001110110100101
10001010001000101001
11101110100011000011
10000000010100011021
11111111111111111111
ENDL