111111111111111111111111111
100010000000000100000000001
100010000010000100000000001
100010000000000100000000001
100011101011111100000000001
100000001000000100000000001
100000001000000100000000001
100000001000000100000000001
101111111111110100000000001
100000000000000100000000001
100000000000000100000000001
100000000000000100000000001
100010000000000100000000001
100010000000000100000000001
100010000000000100000000001
100010000000000100000000001
100011111000000100000000001
100000000000000100000000001
100000000000000100000000001
100000000000000000000000001
111111111111111111111111111